ALA = "countries/Alabama.txt"
DCD = "countries/District of Columbia.txt"
AKA = "countries/Alaska.txt"
AZA = "countries/Arizona.txt"
ARA	= "countries/Arkansas.txt"
CAC	= "countries/California.txt"
COC	= "countries/Colorado.txt"
CTC	= "countries/Connecticut.txt"
DED	= "countries/Delaware.txt"
FLF	= "countries/Florida.txt"
GAG = "countries/Georgia.txt"
HIH	= "countries/Hawaii.txt"
IDI	= "countries/Idaho.txt"
ILI	= "countries/Illinois.txt"
INI	= "countries/Indiana.txt"
IAI = "countries/Iowa.txt"
KSK = "countries/Kansas.txt"
KYK = "countries/Kentucky.txt"
LAL = "countries/Louisiana.txt"
MEM = "countries/Maine.txt"
MDM = "countries/Maryland.txt"
MAM = "countries/Massachusetts.txt"
MIM = "countries/Michigan.txt"
MNM = "countries/Minnesota.txt"
MSM = "countries/Mississippi.txt"
MOM = "countries/Missouri.txt"
MTM = "countries/Montana.txt"
NEN = "countries/Nebraska.txt"
NVN = "countries/Nevada.txt"
NHN = "countries/New Hampshire.txt"
NJN = "countries/New Jersey.txt"
NMN = "countries/New Mexico.txt"
NYN = "countries/New York.txt"
NCN = "countries/North Carolina.txt"
NDN = "countries/North Dakota.txt"
OHO = "countries/Ohio.txt"
OKO = "countries/Oklahoma.txt"
ORO = "countries/Oregon.txt"
PAP = "countries/Pennsylvania.txt"
RIR = "countries/Rhode Island.txt"
SCS = "countries/South Carolina.txt"
SDS = "countries/South Dakota.txt"
TNT = "countries/Tennessee.txt"
TXT = "countries/Texas.txt"
VTV = "countries/Vermont.txt"
VAV = "countries/Virginia.txt"
WAW = "countries/Washington.txt"
WVW = "countries/West Virginia.txt"
WIW = "countries/Wisconsin.txt"
WYW = "countries/Wyoming.txt"
UTU = "countries/Utah.txt"
PRP = "countries/Puerto Rico.txt"
UVU = "countries/United States Virgin Islands.txt"
MWM = "countries/Midway Island.txt"
WKW = "countries/Wake Island.txt"
PIP = "countries/Phoenix Islands.txt"
JAJ = "countries/Johnston Atoll.txt"
PCP = "countries/Panama Canal.txt"
LIL = "countries/Line Islands.txt"
GUG = "countries/Guam.txt"
ASA = "countries/American Samoa.txt"
ABA = "countries/Alberta.txt"
BCB = "countries/British Columbia.txt"
MBM = "countries/Manitoba.txt"
NBN = "countries/New Brunswick.txt"
NLN = "countries/Newfoundland.txt"
NSN = "countries/Nova Scotia.txt"
NTN = "countries/Northwest Territories.txt"
NUN = "countries/Nunavut.txt"
ONO = "countries/Ontario.txt"
PEP = "countries/Prince Edward Island.txt"
QBC = "countries/Quebec.txt"
SKS = "countries/Saskatchewan.txt"
YTY = "countries/Yukon.txt"
LAB = "countries/Labrador.txt"
GUE = "countries/Guerrero.txt"
COU = "countries/Coahuila.txt"
CIA = "countries/Chihuahua.txt"
OAX = "countries/Oaxaca.txt"
CHP = "countries/Chiapas.txt"
OME = "countries/Old Mexico.txt"
YUC = "countries/Yucatan.txt"
GRN = "countries/Greenland.txt"
BAJ = "countries/Baja California.txt"
VEC = "countries/Veracruz.txt"
NAY = "countries/Nayarit.txt"
SON = "countries/Sonora.txt"
TAU = "countries/Tamaulipas.txt"
SIN = "countries/Sinaloa.txt"
SUP = "countries/Superior.txt"
NYC = "countries/Long Island.txt"
###Developer
AAA = "countries/Wastes.txt"
